1111111111111
1C010T000T0C1
1000011111001
1P0011ET00001
1111111111111
